00 01 02 00 01 02 00 01 02 00
01 02 00 01 02 00 01 02 00 01
02 00 11 04 04 04 04 04 04 04
00 01 10 03 03 03 03 03 03 03
01 02 10 03 08 08 08 08 08 08
02 00 10 06 00 01 02 00 01 02
